1111111111
1EC0001011
1111000101
10000P0001
1111111111