11111111111111111111111111111111111111111111111
11110000000000000000000000000000000000000000101
10CE0000000000000000000000000000000000000001011
11110000000000000000000000000000000000000000101
11110000000000000000000000000000000000000000101
11110000000000000000000000000000000000000000101
11110000000000000000000000000000000000000000101
11110000000000000000000000000000000000000000101
11110000000000000000000000000000000000000000101
11110000000000000000000000000000000000000000101
11110000000000000000000000000000000000000000101
11110000000000000000000000000000000000000000101
11110000000000000000000000000000000000000000101
1111000000000000000000000P000000000000000000101
11110000000000000000000000000000000000000000101
11110000000000000000000000000000000000000000101
11110000000000000000000000000000000000000000101
11110000000000000000000000000000000000000000101
11110000000000000000000000000000000000000000101
11110000000000000000000000000000000000000000101
11110000000000000000000000000000000000000000101
11110000000000000000000000000000000000000000101
11110000000000000000000000000000000000000000101
11110000000000000000000000000000000000000000101
11110000000000000000000000000000000000000000101
11110000000000000000000000000000000000000000101
11110000000000000000000000000000000000000000101
11110000000000000000000000000000000000000000101
11110000000000000000000000000000000000000000101
11110000000000000000000000000000000000000000101
11110000000000000000000000000000000000000000101
11110000000000000000000000000000000000000000101
11110000000000000000000000000000000000000000101
11110000000000000000000000000000000000000000101
11110000000000000000000000000000000000000000101
11110000000000000000000000000000000000000000101
11110000000000000000000000000000000000000000101
11110000000000000000000000000000000000000000101
11110000000000000000000000000000000000000000101
11110000000000000000000000000000000000000000101
11110000000000000000000000000000000000000000101
11110000000000000000000000000000000000000000101
11110000000000000000000000000000000000000000101
11110000000000000000000000000000000000000000101
11110000000000000000000000000000000000000000101
11110000000000000000000000000000000000000000101
11110000000000000000000000000000000000000000101
11110000000000000000000000000000000000000000101
11110000000000000000000000000000000000000000101
11110000000000000000000000000000000000000000101
11110000000000000000000000000000000000000000101
10000000000000000000000000000000000000000000001
11111111111111111111111111111111111111111111111